wwwww
ww.gw
w.3.w
w.www
w...w
ww+.w
www.w
wA..w
wwwww