wwwwwwwwwwwww
w......w....w
w.w..w......w
ww..........w
ww...2......w
w...........w
w....w.A....w
w...........w
w.....1...g.w
w....1.....1w
w...........w
w...........w
w...........w
w...........w
w...2....2..w
w...........w
w...........w
w...........w
w...........w
w+..........w
w.w.........w
w3......w...w
w...........w
wwwwwwwwwwwww