wwwwwwwwwwwwwwwwwww
w......1..........w
w......A...w......w
w...w......3......w
w.............w...w
w.w...............w
w...w..w..........w
w..g3.............w
w...........w.....w
w.........3.....+.w
w.....w...w.......w
wwwwwwwwwwwwwwwwwww