wwwwwww
w2...gw
w.w..ww
w.Aw..w
w..w..w
w..w1.w
w..w..w
w+.3..w
w.....w
wwwwwww