wwwwwwwwwwwwwwwwwww
w............w....w
w................ww
w.2..w............w
w........13w...1..w
w.................w
w.................w
w..........w......w
w.................w
w...w.1..+.w......w
w.......1......3..w
w.................w
w.................w
w.....2......w....w
w..........33..w..w
w.................w
w.................w
w.w...............w
w.................w
w..1A...w.........w
w..2..............w
w..wg............3w
w.............ww..w
w.....w..3.......1w
wwwwwwwwwwwwwwwwwww