wwwwwwwwwwwwwwwwwwww
w...+g...1.w...2...w
w..................w
w..................w
w..................w
w.w................w
w.w.........1.....3w
w..................w
w.w..w1............w
ww...............3.w
www........w.......w
w........A.........w
w.w...2...........ww
w...2....w........2w
w..................w
w..................w
w......3.......2...w
wwwwwwwwwwwwwwwwwwww