wwwwwwwwwwwwwwwwwwwwwwww
w....2.................w
ww.......2.............w
w.....................ww
w................+...1.w
w...........w1.....w...w
w.3..............A.....w
w...g...........2......w
w..w............3......w
w......................w
wwwwwwwwwwwwwwwwwwwwwwww