wwwww
w...w
wA.ww
w..ww
w...w
w...w
w...w
w..ww
w...w
w..ww
w..ww
w..gw
w...w
w...w
w...w
w...w
w...w
w..+w
w...w
ww..w
wwwww