wwwwwwwwww
w...w....w
w+1......w
w........w
w........w
w3..2....w
w2.....w.w
w........w
w.3...w..w
w........w
w.A......w
w...2.1..w
w...w.g..w
wwwwwwwwww