wwwwwwwwwwwwwwwwwwwwwwwww
w...............1.......w
w.w....w....w...........w
w3....................2.w
w..2..........2.....3.1.w
w.11.......1............w
w.....w.................w
w.....w.................w
w...........2...........w
w.........w...g........2w
w...2......+............w
w....2......w...........w
w..w.................1..w
w.................1....ww
w.......................w
wwA.....................w
w.............w.........w
wwwwwwwwwwwwwwwwwwwwwwwww